|name|clangd
|CalcCenteroid|clangd
mR|mRadius|clangd
mC|mCenter|clangd
mM|mMass|clangd
mG|mG|clangd
mT|mTotalForce|clangd
INIT|INITIAL_HORIZONTAL_VELOCITY|clangd
mV|mVelocity|clangd
DEF|DEF_VERTEX_ATTRI|clangd
count|counter|clangd
st|stones|clangd
.n|.nValue|clangd
in|include|file
img|Imguizmo|file
Fil|FileDialog|file
|include|file
|FileDialog|file
|Imgui|file
vect|vector>|clangd
vec|vector>|clangd
PROJ|PROJECT_NAME|coc-cmake
w_|w_idw_i|around
w_i|w_idw_i|around
w_id|w_idw_i|around
w_idw_i|w_idw_i|around
pub|public|clangd
NDfs|NDFs|around
inc|include|clangd
cer|cer_key|pyright
n|num_T|clangd
tank|tank_t|clangd
vims|vimspector|around
Ma|Makefile|around
Mak|Makefile|around